1111111111111111111111111111111111
1E00000000000O0C00000C000000000001
1010010100100000101001000000010101
1010010010101010001001000000010111
1P0000O00C00C000O000000000000000C1
1111111111111111111111111111111111